111111111
1POOOCOO1
1111OO1O1
1CCOO1OO1
11OOOOOO1
1COCOCOC1
1111111C1
1OC1OOOO1
1OOOOOOE1
111111111