111111111
1POOOCOO1
1111OO1O1
1CCOOCOO1
11OCO1OO1
1COCOCOC1
1111111C1
11C1OOOO1
1CEOOO1C1
111111111