11111111111111111
1POOOOOOC1CCO1CC1
111O11CC11C111CC1
11OOOCC11CC111CC1
1EOOOOOOOOOOOOOO1
11111111111111111