11111111111111111
1POOOOOOC1CCO1CC1
111O11CC11C111CC1
1OOOOCC11CC111CC1
1OOOOOOOOOOOOOOE1
11111111111111111