11111111111111111
1POOOOOOC1OOO1CC1
111O11CC111111CC1
1OOOOCC11CC111CC1
1OOOOOOOOOOOOOOE1
11111111111111111