11111111111111111
1POOOOOOOOOOO1CC1
111111CC111111CC1
1OOOOCC1111111CC1
1OOOOOOOOOOOOOOE1
11111111111111111