1111111111111111111111111111111111
1EOOOOOOOOOOOOOCOOOOOCOOOOOOOOOOO1
1O1OO1O1OO1OOOOO1O1OO1OOOOOOO1O1O1
1O1OO1OO1O1O1O1OOO1OO1OOOOOOO1O1O1
1POOOOOOOCOOCOOOOOOOOOOOOOOOOOOOC1
1111111111111111111111111111111111